4444444444444444444444444444
4555555555555445555555555554
4544445444445445444445444454
4u444454444454454444454444u4
4544445444445445444445444454
4555555555555555555555555554
4544445445444444445445444454
4544445445444444445445444454
4555555445555445555445555554
4444445444440440444445444444
0000045444440440444445400000
0000045440000000000445400000
0000045440444--4440445400000
4444445440400000040445444444
0000005000400000040005000000
4444445440400000040445444444
0000045440444444440445400000
0000045440000000000445400000
0000045440444444440445400000
4444445440444444440445444444
4555555555555445555555555554
4544445444445445444445444454
4544445444445445444445444454
4u554455555555555555554455u4
4445445445444444445445445444
4445445445444444445445445444
4555555445555445555445555554
4544444444445445444444444454
4544444444445445444444444454
4555555555555555555555555554
4444444444444444444444444444